EA ./texture/red_brick.xpm

NO ./texture/wood.xpm

SO ./texture/purple_stone.xpm

WE ./texture/color_stone.xpm

F 112,112,112
C 56,56,56

111111
100101
1010D1
1100N1
111111