NO ./texture/wood.png


	
SO ./texture/purplestone.png




WE ./texture/colorstone.png

EA ./texture/redbrick.png



F    127,255,170



 	
C 176,224,230 



11111111
10000001
100W0001
10000001
10000001
10000001
10000001
10000001
10000001
10000001
10000001
10000001
10000001
10000001
10000001
10000001
10000001
10000001
11111111

